[
_8   9   8   8       8          8   8           8     8      8          8         8   8      8   8     8     8  |
                8  8     8  8           8   8      8      8     8   8       8   8         8          8     8    |
                                                            #                                                  8|
8                                                                                                               |
                                                         8     2             1111                              8|
              1          1111      21111                                    1    1                              |
8            1 1         1  1      1                                        1    1     1                        |
            1   1       1   1      1                 o    8                 1    1                           N 8|
           1121111     1    1      1                                        1    1                              |
8         1       1   1     2      1                                   1     1111                               |
                                                  8     8                                       1               |
                                                     8                                     1                    |
8     1            1                                       1                                                    |
           1                                                                                                    |
                           1                 8   1                            1                                 |
8                                      O                                                                        |
         1          2                                                8   8                                      |
                                   8                             8                    t                         |
8               1                                          1                                                    |
      1                                                                     8                                 8 |
                                8                              8                                *               |
 8                2                                                                           *   *             |
      M                                              1                        8          A  *   t   *          8|
                             8                                8                               *   *             |
8                                                                                               *               |
                                8                                            8                                  |
                                                               8                                               8|
                                   8                                                                            |
8        8        8                    8        8          8                   8     8                 8        |
  8  8      8  8      8 -T-- 8   8  8     8  8    8 -T- 8      8            8     8     8   8   8   8    8  8   |
]

player 500 1200

/