[
 8               8     8  8    8       8  |
   8          8     8       8            8|
8                                8        |
    1                                     |
                                        8 |
8                    1                    |
              1                           |
      1                 W           1    8|
 8                                        |
    1            1             F          |
8                                       8 |
                                1         |
            1                             |
8   A                             1      8|
              1                           |
    1                       1             |
 8                  1                   8 |
          1                      1        |
    1                                    8|
                          1               |
 8        8        8      8  8    8      8|
    8  8     8  8    8  8       8   8  8  |
]
player 55 1600 

/
