[
8       8  8   1      1  8    8     8  |
  8  8         1      1     8    8    8|
8             1        1               |
              1        1               |
            11          11           8 |
8         11              11           |
        11      M           11         |
       1                      1       8|
 8     1                      1        |
      1                        1       |
      1             W    a     1       |
     1                          1    8 |
8    1                          1      |
      1                        1       |
      1                        1      8|
8      1                      1        |
       1                      1        |
  _     1                    1        8|
 8      1                    1         |
         1  k           K   1          |
8         11              11         8 |
            11          11             |
       h      11      11     H         |
8                 F                   8|
                                       |
                                       |
 8                                   8 |
                                       |
      A                               8|
                                       |
 8        8             8     8       8|
    8  8     8  8    8          8  8   |
]

/
