[
8     8  8      8  8          8   8     8   8   8     8      8  8|
   8        8         8   8          8              8     8      |
        8                                              8         |
8         8                                                     8|
       8                                                         |
 8          8                                        8           |
         8                                                     8 |
                8                             F                  |
8                    A                             8             |
             8                                                   |
                 8                                              8|
 8                   8                                           |
                                                                 |
                      8                   W                    8 |
                  8                                              |
8                       8                     8                  |
                                       8                         |
                                           8                    8|
 8                                  8                            |
                                                                 |
                                                               8 |
                                  8                              |
                                                                 |
                                                               8 |
                                    8                            |
                 8                                               |
                                                        K       8|
      8      8       8  8        8          8     8              |
8  8      8    8   8       8  8     8   8     8     8_         8 |
]
player 55 1600 

/
